{"main": [[".","X","X","X","X","X",".","."],
          ["X","X","_","_","X","X","X","."],
          ["X","P","_","_","O","_","X","X"],
          ["X","_","X","_","X","_","_","X"],
          ["X","_","_","O","_","_","_","X"],
          ["X","X","X","X","X","_","_","X"],
          [".",".",".",".","X","X","X","X"]],
 "trgt": [[".","_","_","_","_","_",".","."],
          ["_","_","_","_","_","_","_","."],
          ["_","_","_","_","_","_","_","_"],
          ["_","_","_","_","_","_","_","_"],
          ["_","_","_","_","_","_","_","_"],
          ["_","_","_","_","_","*","*","_"],
          [".",".",".",".","_","_","_","_"]]}
